11111111111111111111111111111111
10000000000000000000000000000001
10030000000000000000000000000001
10000000000000000000000000000001
11111111111111111110003000001111
10000000000000010000000000000001
10000000000000010000000000000001
10000100000000010000000000000001
10000100000000010000002000000001
10000100000000010000000000000001
10000100003000010000000000000001
10000100000000011110000000001111
10000000000000000003000000000001
10000000000000000000000000000001
10000111111111110000000000000001
10000000000000000000000000000001
10000000000000000000000000000001
11111111111111111111111111111111